---oooooooooooooooooooooooooo---
-s----------------------------s-
------------o---o------o--------
o----ooo---ooo--oo----oo-------o
o-----o---------o------o-------o
o------------------------------o
o-----o-----o---oo----oo-------o
o-----oo---oo---o------o-------o
o------------------------------o
o-----o---------o--------------o
o-----o----oo---o-----ooo------o
o---------------o--------------o
o-----o------------------------o
o---------------------o--------o
o--------------------ooo-------o
o-----ooooooo---------o--------o
o----ooooo---------------------o
o-----o------------------------o
o---------------ooooooooooo----o
o--------------oo--------------o
o--------oo----oo--------------o
o--------oo----oo--------------o
o--------oo-----o--------------o
o--------oo----oo--------------o
o--------oo----ooo-------------o
o--------ooooooooo-------------o
o---------------oo-------------o
o---------------oo-------------o
o--------------oo--------------o
-------------------------------o
-s----------------------------to
---wwwwwwwwwwwwwwwwwwwwwwwwwwwwo