oooooooooooooooooooooooooooooooo
o------------------------------o
o-s---------o---o------o------s-o
o----ooo---ooo--oo----oo-------o
o-----o---------o------o-------o
o------------------------------o
o-----o-----o---oo----oo-------o
o-----oo---oo---o------o-------o
o------------------------------o
o-----o---------o--------------o
o-----o----oo---o-----ooo------o
o---------------o--------------o
o-----o------------------------o
o------------------------------o
o------------------------------o
o-----o------------------------o
o----ooo-----------------------o
o-----o------------------------o
o---------------ooooooooooo----o
o--------------oo--------------o
o--------------oo--------------o
o--------------oo--------------o
o---------------o--------------o
o--------------oo--------------o
o--------------ooo-------------o
o--------------ooo-------------o
o---------------oo-------------o
o---------------oo-------------o
o--------------oo--------------o
o-s----------------------------o
o-----------------------------to
wwwwwwwwwwwwwwwwwwwwwwwwwwwwwwwo