-----ooooooooooooooooooooooooooo
-s----------------------------so
-------------------------------o
-------------------o-----------o
o------------------o-----------o
o------------------o-----------o
o------------------o-----------o
o------------------o-----------o
o------------------o-----------o
o------------------o-----------o
o------------------o-----------o
o--------ooooo-----o-----------o
o------------------o-----------o
o------------------o-----------o
o------------------o-----------o
o------------------o-----------o
o------------------o-----------o
o------------------o-----------o
o------------------o-----------o
o------------------o-----------o
o------------------o-----------o
o------------------o-----------o
o------------------o-----------o
o-----------oo-----o-----------o
o----------oo------o-----------o
o---------oo-------o-----------o
o--------oo--------o-----------o
o-------oo---------o-----------o
o-------o-----------o-----------o
o------------------------------o
os----------------------------to
wwwwwwwwwwwwwwwwwwwwwwwwwwwwwwwo