oooooooooooooooooooooooooooooooo
os----------------------------so
o-----------o---o------o-------o
o----ooo---ooo--oo----oo-------o
o-----o---------o------o-------o
o------------------------------o
o-----o-----o---oo----oo-------o
o-----oo---oo---o------o-------o
o------------------------------o
o-----o---------o--------------o
o-----o----oo---o-----ooo------o
o---------------o--------------o
o-----o------------------------o
o------------------------------o
o------------------------------o
o-----o------------------------o
o----ooo-----------------------o
o-----o------------------------o
o---------------ooooooooooo----o
o--------------oo--------------o
o--------------oo--------------o
o--------------oo--------------o
o---------------o--------------o
o--------------oo--------------o
o--------------ooo-------------o
o--------------ooo-------------o
o---------------oo-------------o
o---------------oo-------------o
o--------------oo--------------o
o------------------------------o
os----------------------------to
wwwwwwwwwwwwwwwwwwwwwwwwwwwwwwwo